25 25
100 100
6 6  6  6  6  6  6  6  6  6  6  6  6  6  6  6  6  6  6  6  6  6  6  6  6
6 1  2  1  1  1  1  1  1  5  1  1  1  1  1  1  1  1  1  1  1  1  1  1  6
6 1  1  1  1  3  1  1  1  1  1  1  1  2  1  1  1  1  1  1  1  1  1  1  6
6 1  1  1  1  1  1  2  2  2  2  2  1  1  1  1  1  1  1  1  1  1  1  1  6
6 1  1  1  1  1  1  2  2  8  8  2  1  1  1  1  1  1  1  1  1  1  1  1  6
6 1  1  1  1  1  1  1  2  8  8  2  1  2  3  1  1  1  1  1  1  1  1  1  6
6 1  5  1  1  1  1  1  2  2  2  2  1  1  1  1  1  1  8  1  1  1  1  1  6
6 1  1  1  1  1  1  2  1  1  1  2  1  1  1  1  1  1  1  1  1  1  1  1  6
6 1  1  1  1  1  1  1  3  1  1  2  2  1  1  1  1  1  1  1  1  1  1  1  6
6 1  1  1  1  1  3  3  3  1  1  1  1  1  1  1  1  1  1  1  1  1  1  1  6
6 1  1  1  1  1  3  1  1  1  1  1  1  1  1  1  1  1  1  1  1  1  1  1  6
6 1  1  1  1  1  3  1  1  1  1  3  1  1  1  1  1  1  1  5  1  1  1  1  6
6 1  1  1  1  1  1  1  1  1  1  1  1  1  1  1  1  1  1  1  1  1  1  1  6
6 1  1  1  1  1  1  1  1  1  1  1  1  1  1  1  1  1  1  1  1  1  1  1  6
6 1  1  1  1  8  1  1  1  2  1  1  1  1  1  1  1  1  1  1  1  1  1  1  6
6 1  1  1  1  1  1  1  1  1  1  1  1  1  1  1  1  1  1  1  1  1  1  1  6
6 1  1  1  1  1  1  2  1  1  1  1  3  1  2  1  1  1  1  1  1  1  1  1  6
6 1  1  1  5  1  1  1  1  1  1  1  1  1  1  1  1  1  1  1  1  1  1  1  6
6 1  1  1  2  1  1  1  1  1  1  1  5  1  1  1  1  1  1  1  1  1  1  1  6
6 1  1  1  1  1  1  1  1  1  1  1  1  1  1  1  1  1  1  1  1  1  1  1  6
6 1  1  1  1  1  1  1  2  8  1  1  1  1  1  1  1  1  1  1  1  1  1  1  6
6 1  1  1  2  1  1  1  2  1  1  1  1  2  1  1  1  1  1  1  1  1  1  1  6
6 1  1  1  1  1  1  1  2  1  1  1  1  1  1  1  1  1  1  1  1  1  1  1  6
6 1  1  1  1  1  1  1  1  1  1  1  1  1  1  1  1  1  1  1  1  1  1  1  6
6 6  6  6  6  6  6  6  6  6  6  6  6  6  6  6  6  6  6  6  6  6  6  6  6