25 25
100 100
1 6  6  6  6  6  6  6  6  6  6  6  6  6  6  6  6  6  6  6  6  6  6  6  6
6 2  5  3  3  2  1  6  6  5  1  1  3  1  2  2  1  3  5  2  3  3  2  1  6
6 2  1  1  5  3  5  6  6  1  1  5  2  2  1  2  1  1  2  1  2  1  1  1  6
6 1  1  2  3  1  1  6  6  2  2  2  2  1  2  3  5  5  1  5  3  1  2  2  6
6 2  3  2  1  4  2  6  6  1  1  3  1  1  1  3  3  1  1  1  2  5  1  1  6
6 5  2  4  2  5  3  6  6  1  1  2  5  2  3  3  6  6  5  1  4  1  1  4  6
6 5  1  2  1  5  1  6  6  2  2  2  3  1  1  3  6  6  1  2  1  2  3  1  6
6 3  4  1  2  2  1  6  6  5  2  3  5  1  5  1  6  6  2  1  3  1  1  1  6
6 3  1  2  1  1  1  6  6  1  1  2  2  1  1  4  6  6  5  1  4  1  4  3  6
6 1  5  1  5  2  3  6  6  5  5  3  1  2  2  1  6  6  1  1  2  1  1  1  6
6 4  1  3  1  3  3  6  6  3  1  1  1  2  1  5  6  6  1  1  1  2  5  1  6
6 1  2  1  2  1  3  6  6  5  1  3  3  1  1  1  6  6  5  5  1  1  1  4  6
6 5  8  2  1  2  1  6  6  1  1  1  4  4  2  4  6  6  1  1  4  3  5  1  6
6 1  1  1  4  1  4  6  6  1  8  4  1  1  8  2  6  6  1  3  1  2  1  3  6
6 4  3  3  5  3  4  6  6  3  1  4  2  4  4  1  6  6  2  1  1  1  5  1  6
6 1  1  1  1  1  2  6  6  1  2  3  3  1  5  1  6  6  3  5  4  2  5  1  6
6 5  5  5  1  3  1  6  6  2  1  5  3  5  9  3  6  6  1  1  1  1  1  1  6
6 1  1  1  5  9  5  6  6  1  1  2  1  2  5  5  6  6  1  2  1  5  1  5  6
6 4  1  2  2  1  2  6  6  2  8  2  5  3  5  4  6  6  3  1  4  1  3  2  6
6 1  2  1  1  1  1  6  6  1  1  1  2  1  2  1  6  6  1  2  1  3  1  1  6
6 2  1  5  1  5  5  1  2  2  5  5  1  1  1  3  6  6  8  3  5  4  3  8  6
6 3  3  1  2  1  3  3  2  1  2  1  3  2  3  1  6  6  1  2  1  2  3  2  6
6 2  1  5  1  1  1  5  2  2  1  5  4  1  1  2  6  6  2  4  5  5  2  1  6
6 1  4  1  3  2  1  1  1  4  1  5  4  1  5  1  6  6  8  2  1  3  5  8  6
6 6  6  6  6  6  6  6  6  6  6  6  6  6  6  6  6  6  6  6  6  6  6  6  6